lakaskultura|lakaskultura.hu
szegedma|szegedma.hu
ripost|ripost.hu
borsonline|borsonline.hu
dietaesfitnesz|dietaesfitnesz.hu
likebalaton|likebalaton.hu
magyarnemzet|magyarnemzet.hu
mandiner|mandiner.hu
vitorlazasmagazin|vitorlazasmagazin.hu
szabadfold|szabadfold.hu
szoljon|szoljon.hu
sonline|sonline.hu
szon|szon.hu
vaol|vaol.hu
zaol|zaol.hu
duol|duol.hu
feol|feol.hu
heol|heol.hu
veol|veol.hu
teol|teol.hu
beol|beol.hu
haon|haon.hu
baon|baon.hu
boon|boon.hu
nool|nool.hu
bama|bama.hu
kemma|kemma.hu
hirnyolc|hirnyolc.hu
nemzetisport|nemzetisport.hu
888|888.hu
agrokep|agrokep.vg.hu
figyelo|figyelo.hu
shelife|she.life.hu
she|she.hu
life|life.hu
sportslife|sportslife.hu
unilife|unilife.hu
vg|vg.hu
thatslife|thatslife.hu
sulilife|sulilife.hu
sulilifeunilife|sulilife.unilife.hu
